Version 0.9.7
4
 4 5 177 77 128 0 1
 5 80 400 206 81 2 2
 0 97 56 877 276 8 3
 1 96 362 206 81 140 4
 0
17
 0 5 66 290 66 290 66 317 66 317 150 317 150 317 0 1 0 3
 255 5 66 191 66 191 66 191 66 83 150 83 150 83 0 1 0 3
 255 5 66 204 66 204 50 204 50 373 111 373 111 373 0 1 0 4
 0 5 66 277 66 277 66 431 66 431 111 431 111 431 0 1 0 4
 0 5 306 265 306 265 306 265 306 317 306 317 306 317 0 3 0 3
 0 5 436 265 436 265 436 265 436 317 436 317 436 317 0 3 0 3
 0 5 566 265 566 265 566 265 566 317 566 317 566 317 0 3 0 3
 0 5 696 265 696 265 696 265 696 317 696 317 696 317 0 3 0 3
 255 5 228 122 228 122 228 122 228 83 228 83 228 83 0 3 0 3
 255 5 358 122 358 122 358 122 358 83 358 83 358 83 0 3 0 3
 255 5 488 122 488 122 488 122 488 83 488 83 488 83 0 3 0 3
 255 5 618 122 618 122 618 122 618 83 618 83 618 83 0 3 0 3
 65280 5 152 373 153 373 153 330 228 330 228 265 228 265 0 4 0 3
 65280 5 152 386 159 386 159 336 358 336 358 226 358 226 0 4 0 3
 16711680 5 171 373 171 373 171 344 371 344 371 226 371 226 0 4 0 3
 16744576 5 384 226 384 226 384 226 397 226 397 226 397 226 0 3 0 3
 16744576 5 384 239 384 239 384 266 254 266 254 265 254 265 0 3 0 3
4
 7086 1 14 352 174 5 0 8583336 22108528 3
 7004 1 14 222 174 5 0 8583336 22108528 3
 7008 1 14 482 174 5 0 8583336 22108528 3
 7032 1 14 612 174 5 0 8583336 22108528 3
